###############
#   ##      # #
# ####  ##    #
#   #  ##  #  #
### # ##  #   #
#   #     #   #
###############